xxxxxxxxxxxxxxxxxxxx
xxxx              xx
xxx               xx
xx                xx
x                 xx
x                 xx
x                 xx
x                 xx
x                 xx
x                 xx
x                 xx
x       x         xx
x       x         xx
xx      x         xx
xxx     x         xx
xx      x         xx
x       x         xx
x       x         xx
x                 xx
x                 xx
x                 xx
x                 xx
x                 xx
x                 xx
x                 xx
x                 xx
xx                xx
xxx               xx
xxxx              xx
xxxxxxxxxxxxxxxxxxxx